WE srcs/textures/wall1.XPM
SO srcs/textures/wall2.XPM
NO srcs/textures/wall3.XPM
EA srcs/textures/wall4.XPM
F 14,88,228
C 137,13,37
1111111111111111111111111
1110000000110000010000001
1110000000110000010000001
1000000000110000010000001
1000000000110000010000001
1000N00000110000010000001
1000000000000000010000001
1000000000110000010000001
1000000000110000010000001
1000000000110000010000001
1111111111111111111111111
